NO ./textures/N.xpm
SO ./textures/S.xpm
WE ./textures/W.xpm
EA ./textures/E.xpm

F 251,       255, 255

                                   
										

C 30, 100, 225

111111111111111111111111111
100000000000000000000000001
100000000000000000000000001
100000000001100000000N00001
100000000001100011000000001    111
111000000001100000000000001    101
111111111111111111111111111    101
                               111
111
101
111
