NO ./textures/space1.xpm
SO ./textures/space2.xpm
WE ./textures/space3.xpm
EA ./textures/space4.xpm

F 45,       45, 45
C 152, 245, 255



              11111111111       
          1111000000000001111     
        11000000000000000000011
      110000000000000000000000011
     10000000000000000000000000001
    1000000001110000000111000000001
    100000001   1000001   100000001
   100000000011100000001110000000001
   100000000000000000000000000000001  
   100000000000000000N00000000000001
    1000001111111111111111110000001
    1000001                10000001
     100000111          1110000001
      11000000111     11100000011
        11000000011111000000011
          1111000000000001111
              11111111111    

              111
              101
              111